NO sprites/north_wall.xpm
SO sprites/south_wall.xpm
WE sprites/west_wall.xpm
EA sprites/east_wall.xpm

F 255,0,0
C 255,0,0

1111111111
1000100001
1000000001
1000100001
1111111111
