NO sprites/north_wall.xpm
SO sprites/south_wall.xpm
WE sprites/west_wall.xpm
EA sprites/east_wall.xpm

F              0,0,0
C 255,0,0

1111111111
1E00D00001
10D0100001111111111111
100010000110D0100001111111111111111111111111111111111111111111
10D0100001111111111111
10D0100001111111111111
1111111111
1111111111
1000100001
1111111111
1000100001
1111111111
1111111111
1000100001
1111111111
10001000011111111111
1111111111
1000100001
1111111111
1000100001