F 0,0,0
C 0,0,0

NO assets/sprites/future/north_wall.xpm
SO assets/sprites/future/south_wall.xpm
WE assets/sprites/future/west_wall.xpm
EA assets/sprites/future/east_wall.xpm

1111111111111111111
10W1001001001000001
1D11000001000001001
1001001D11111101111
1001111000001001001
100000000000D001001
1D11111111111001001
1111000000000001011
1000000001000000001
1111111111111111111

