F 139,99,58
C 171,154,137

NO sprites/north_wall.xpm
SO sprites/south_wall.xpm
WE sprites/west_wall.xpm
EA sprites/east_wall.xpm

1111111111111111101
1001001001011111101
100100100101      1
1001001001011111111
1001001000001001001
1000000000W00000001
1000011111111000001
1111000000000001111
1000000101010000001
1111111111111111111

