F 139,99,58
C 171,154,137

NO assets/sprites/north_wall.xpm
SO  assets/sprites/south_wall.xpm
WE  assets/sprites/west_wall.xpm
EA  assets/sprites/east_wall.xpm

1111111111111111111
1001001001011111111
1001001001011111111
1001001001011111111
1001001000001001001
1000000000W00000001
1000011111111000001
1111000000000001111
1000000101010000001
1111111111111111111

